渋谷凛	Never say never	cool
双葉杏	あんずのうた	cute
三村かな子	ショコラ・ティアラ	cute
高垣楓	こいかぜ	cool
城ヶ崎莉嘉	DOKIDOKIリズム	passion
神崎蘭子	華蕾夢ミル狂詩曲~魂ノ導~	cool
前川みく	おねだり Shall We~	cute
諸星きらり	ましゅまろ☆キッス	passion
城ヶ崎美嘉	TOKIMEKIエスカレート	passion
島村卯月	S(mile)ING!	cute
小日向美穂	Naked Romance	cute
多田李衣菜	Twilight Sky	cool
十時愛梨	アップルパイ・プリンセス	passion
川島瑞樹	Angel Breeze	cool
本田未央	ミツボシ☆☆★	passion
日野茜	熱血乙女A	passion
赤城みりあ	Romantic Now	passion
安部菜々	メルヘンデビュー！	cute
新田美波	ヴィーナスシンドローム	cool
輿水幸子	To my darling	cute
佐久間まゆ	エヴリデイドリーム	cute
白坂小梅	小さな恋の密室事件	cool
緒方智絵里	風色メロディ	cute
アナスタシア	You're stars shine on me	cool
高森藍子	お散歩カメラ	passion
星輝子	毒茸伝説	passion
神谷奈緒	2nd SIDE	cool
北条加蓮	薄荷	cool
小早川紗枝	花簪 HANAKANZASHI	cute
堀裕子	ミラクルテレパシー	passion
鷺沢文香	Bright Blue	cool
姫川友紀	気持ちいいよね 一等賞！	passion
宮本フレデリカ	き・ま・ぐ・れ☆Cafe au lait!	cute
速水奏	Hotel Moonside	cool
市原仁奈	みんなのきもち	passion
橘ありす	in fact	cool
片桐早苗	Can't Stop!!	passion
一ノ瀬志希	秘密のトワレ	cute
塩見周子	青の一番星	cool
櫻井桃華	ラヴィアンローズ	cute
大槻唯	Radio Happy	passion
中野有香	恋色エナジー	cute
二宮飛鳥	共鳴世界の存在論	cool
相葉夕美	lilac time	passion
五十嵐響子	恋のHamburg♪	cute
乙倉悠貴	追い風 Running	cute
松永涼	One Life	cool
依田芳乃	祈りの花	passion
